11111
10E01
10C01
10PC1
11111
